sci_name	parent_name	superparent_name
grain metagenome	organismal metagenomes	metagenomes
beetle metagenome	organismal metagenomes	metagenomes
respiratory tract metagenome	organismal metagenomes	metagenomes
oral fungal metagenome	organismal metagenomes	metagenomes
eukaryotic plankton metagenome	organismal metagenomes	metagenomes
shrimp gut metagenome	organismal metagenomes	metagenomes
human skeleton metagenome	organismal metagenomes	metagenomes
bovine metagenome	organismal metagenomes	metagenomes
pig metagenome	organismal metagenomes	metagenomes
gonad metagenome	organismal metagenomes	metagenomes
microeukaryotic metagenome	organismal metagenomes	metagenomes
oral metagenome	organismal metagenomes	metagenomes
echinoderm metagenome	organismal metagenomes	metagenomes
human brain metagenome	organismal metagenomes	metagenomes
sea anemone metagenome	organismal metagenomes	metagenomes
human reproductive system metagenome	organismal metagenomes	metagenomes
whole organism metagenome	organismal metagenomes	metagenomes
bee bread metagenome	organismal metagenomes	metagenomes
bacterioplankton metagenome	organismal metagenomes	metagenomes
bovine gut metagenome	organismal metagenomes	metagenomes
marine picoeukaryotic metagenome	organismal metagenomes	metagenomes
plant metagenome	organismal metagenomes	metagenomes
bat gut metagenome	organismal metagenomes	metagenomes
urine metagenome	organismal metagenomes	metagenomes
insect gut metagenome	organismal metagenomes	metagenomes
fish metagenome	organismal metagenomes	metagenomes
bat metagenome	organismal metagenomes	metagenomes
flower metagenome	organismal metagenomes	metagenomes
vaginal metagenome	organismal metagenomes	metagenomes
human skin metagenome	organismal metagenomes	metagenomes
shark metagenome	organismal metagenomes	metagenomes
algal bloom metagenome	organismal metagenomes	metagenomes
liver metagenome	organismal metagenomes	metagenomes
human feces metagenome	organismal metagenomes	metagenomes
goat gut metagenome	organismal metagenomes	metagenomes
microeukaryotic plankton metagenome	organismal metagenomes	metagenomes
rat metagenome	organismal metagenomes	metagenomes
granuloma metagenome	organismal metagenomes	metagenomes
oyster metagenome	organismal metagenomes	metagenomes
human nasopharyngeal metagenome	organismal metagenomes	metagenomes
ear metagenome	organismal metagenomes	metagenomes
cellular supernatant metagenome	organismal metagenomes	metagenomes
oral-nasopharyngeal metagenome	organismal metagenomes	metagenomes
viral metagenome	organismal metagenomes	metagenomes
jellyfish metagenome	organismal metagenomes	metagenomes
seagrass metagenome	organismal metagenomes	metagenomes
rabbit gut metagenome	organismal metagenomes	metagenomes
tree metagenome	organismal metagenomes	metagenomes
mammal metagenome	organismal metagenomes	metagenomes
human oral metagenome	organismal metagenomes	metagenomes
starfish metagenome	organismal metagenomes	metagenomes
eukaryotic soil metagenome	organismal metagenomes	metagenomes
cetacean metagenome	organismal metagenomes	metagenomes
snake metagenome	organismal metagenomes	metagenomes
invertebrate gut metagenome	organismal metagenomes	metagenomes
zooxanthellae metagenome	organismal metagenomes	metagenomes
upper respiratory tract metagenome	organismal metagenomes	metagenomes
oral viral metagenome	organismal metagenomes	metagenomes
primate metagenome	organismal metagenomes	metagenomes
shoot metagenome	organismal metagenomes	metagenomes
pig gut metagenome	organismal metagenomes	metagenomes
root nodule metagenome	organismal metagenomes	metagenomes
mouse gut metagenome	organismal metagenomes	metagenomes
zooplankton metagenome	organismal metagenomes	metagenomes
human viral metagenome	organismal metagenomes	metagenomes
human urinary tract metagenome	organismal metagenomes	metagenomes
termite gut metagenome	organismal metagenomes	metagenomes
sheep gut metagenome	organismal metagenomes	metagenomes
tick metagenome	organismal metagenomes	metagenomes
feline metagenome	organismal metagenomes	metagenomes
wildlife metagenome	organismal metagenomes	metagenomes
human uterine metagenome	organismal metagenomes	metagenomes
gut metagenome	organismal metagenomes	metagenomes
prokaryotic metagenome	organismal metagenomes	metagenomes
spider metagenome	organismal metagenomes	metagenomes
human semen metagenome	organismal metagenomes	metagenomes
wallaby gut metagenome	organismal metagenomes	metagenomes
skin metagenome	organismal metagenomes	metagenomes
placenta metagenome	organismal metagenomes	metagenomes
rat gut metagenome	organismal metagenomes	metagenomes
scorpion gut metagenome	organismal metagenomes	metagenomes
photosynthetic picoeukaryotic metagenome	organismal metagenomes	metagenomes
eye metagenome	organismal metagenomes	metagenomes
human eye metagenome	organismal metagenomes	metagenomes
eukaryotic metagenome	organismal metagenomes	metagenomes
human bile metagenome	organismal metagenomes	metagenomes
hydrozoan metagenome	organismal metagenomes	metagenomes
stomach metagenome	organismal metagenomes	metagenomes
macroalgae metagenome	organismal metagenomes	metagenomes
canine gut metagenome	organismal metagenomes	metagenomes
protist metagenome	organismal metagenomes	metagenomes
dinoflagellate metagenome	organismal metagenomes	metagenomes
sugarcane bagasse metagenome	organismal metagenomes	metagenomes
plant fiber metagenome	organismal metagenomes	metagenomes
amphibian metagenome	organismal metagenomes	metagenomes
phytoplankton metagenome	organismal metagenomes	metagenomes
lung metagenome	organismal metagenomes	metagenomes
mouse metagenome	organismal metagenomes	metagenomes
microeukaryotic aquatic metagenome	organismal metagenomes	metagenomes
blood metagenome	organismal metagenomes	metagenomes
phyllosphere metagenome	organismal metagenomes	metagenomes
microbial eukaryotic metagenome	organismal metagenomes	metagenomes
benthos protist metagenome	organismal metagenomes	metagenomes
lichen metagenome	organismal metagenomes	metagenomes
bear gut metagenome	organismal metagenomes	metagenomes
symbiont metagenome	organismal metagenomes	metagenomes
human gut metagenome	organismal metagenomes	metagenomes
peritoneum metagenome	organismal metagenomes	metagenomes
human lung metagenome	organismal metagenomes	metagenomes
endophyte metagenome	organismal metagenomes	metagenomes
reproductive system metagenome	organismal metagenomes	metagenomes
shrew metagenome	organismal metagenomes	metagenomes
phycosphere metagenome	organismal metagenomes	metagenomes
pollen metagenome	organismal metagenomes	metagenomes
urogenital metagenome	organismal metagenomes	metagenomes
psyllid metagenome	organismal metagenomes	metagenomes
wasp metagenome	organismal metagenomes	metagenomes
human blood metagenome	organismal metagenomes	metagenomes
urinary tract metagenome	organismal metagenomes	metagenomes
bile metagenome	organismal metagenomes	metagenomes
symbiotic algae metagenome	organismal metagenomes	metagenomes
semen metagenome	organismal metagenomes	metagenomes
seed metagenome	organismal metagenomes	metagenomes
mosquito metagenome	organismal metagenomes	metagenomes
ovine metagenome	organismal metagenomes	metagenomes
annelid metagenome	organismal metagenomes	metagenomes
algae metagenome	organismal metagenomes	metagenomes
epibiont metagenome	organismal metagenomes	metagenomes
rodent metagenome	organismal metagenomes	metagenomes
ciliate metagenome	organismal metagenomes	metagenomes
crab metagenome	organismal metagenomes	metagenomes
ctenophore metagenome	organismal metagenomes	metagenomes
human milk metagenome	organismal metagenomes	metagenomes
eukaryotic aquatic metagenome	organismal metagenomes	metagenomes
fish gut metagenome	organismal metagenomes	metagenomes
mouse brain metagenome	organismal metagenomes	metagenomes
termite metagenome	organismal metagenomes	metagenomes
human gut metagenome gcode 4	organismal metagenomes	metagenomes
aquatic viral metagenome	organismal metagenomes	metagenomes
equid metagenome	organismal metagenomes	metagenomes
sponge metagenome	organismal metagenomes	metagenomes
bee metagenome	organismal metagenomes	metagenomes
sea squirt metagenome	organismal metagenomes	metagenomes
marine eukaryotic metagenome	organismal metagenomes	metagenomes
root metagenome	organismal metagenomes	metagenomes
nematode metagenome	organismal metagenomes	metagenomes
human hair metagenome	organismal metagenomes	metagenomes
crustacean metagenome	organismal metagenomes	metagenomes
phage metagenome	organismal metagenomes	metagenomes
nervous system metagenome	organismal metagenomes	metagenomes
internal organ metagenome	organismal metagenomes	metagenomes
horse metagenome	organismal metagenomes	metagenomes
sea cucumber metagenome	organismal metagenomes	metagenomes
human vaginal metagenome	organismal metagenomes	metagenomes
marsupial metagenome	organismal metagenomes	metagenomes
canine metagenome	organismal metagenomes	metagenomes
insect metagenome	organismal metagenomes	metagenomes
sea urchin metagenome	organismal metagenomes	metagenomes
human saliva metagenome	organismal metagenomes	metagenomes
human tracheal metagenome	organismal metagenomes	metagenomes
fungus metagenome	organismal metagenomes	metagenomes
mollusc metagenome	organismal metagenomes	metagenomes
human metagenome	organismal metagenomes	metagenomes
sheep metagenome	organismal metagenomes	metagenomes
chicken gut metagenome	organismal metagenomes	metagenomes
claw, hoof, horn & nail metagenome	organismal metagenomes	metagenomes
invertebrate metagenome	organismal metagenomes	metagenomes
koala metagenome	organismal metagenomes	metagenomes
ant metagenome	organismal metagenomes	metagenomes
fossil metagenome	organismal metagenomes	metagenomes
zebrafish metagenome	organismal metagenomes	metagenomes
moss metagenome	organismal metagenomes	metagenomes
coral metagenome	organismal metagenomes	metagenomes
gill metagenome	organismal metagenomes	metagenomes
leaf metagenome	organismal metagenomes	metagenomes
human sputum metagenome	organismal metagenomes	metagenomes
bird metagenome	organismal metagenomes	metagenomes
feces metagenome	organismal metagenomes	metagenomes
parasite metagenome	organismal metagenomes	metagenomes
mouse skin metagenome	organismal metagenomes	metagenomes
mite metagenome	organismal metagenomes	metagenomes
frog metagenome	organismal metagenomes	metagenomes
masonry metagenome	ecological metagenomes	metagenomes
paper pulp metagenome	ecological metagenomes	metagenomes
fuel tank metagenome	ecological metagenomes	metagenomes
HVAC metagenome	ecological metagenomes	metagenomes
oil production facility metagenome	ecological metagenomes	metagenomes
fermentation metagenome	ecological metagenomes	metagenomes
compost metagenome	ecological metagenomes	metagenomes
bioretention column metagenome	ecological metagenomes	metagenomes
coal metagenome	ecological metagenomes	metagenomes
urban metagenome	ecological metagenomes	metagenomes
food metagenome	ecological metagenomes	metagenomes
subsurface metagenome	ecological metagenomes	metagenomes
plankton metagenome	ecological metagenomes	metagenomes
hypersaline lake metagenome	ecological metagenomes	metagenomes
salt marsh metagenome	ecological metagenomes	metagenomes
rock porewater metagenome	ecological metagenomes	metagenomes
biofloc metagenome	ecological metagenomes	metagenomes
aerosol metagenome	ecological metagenomes	metagenomes
food contamination metagenome	ecological metagenomes	metagenomes
termitarium metagenome	ecological metagenomes	metagenomes
tobacco metagenome	ecological metagenomes	metagenomes
crude oil metagenome	ecological metagenomes	metagenomes
volcano metagenome	ecological metagenomes	metagenomes
hyphosphere metagenome	ecological metagenomes	metagenomes
oil metagenome	ecological metagenomes	metagenomes
lobster shelll metagenome	ecological metagenomes	metagenomes
detritusphere metagenome	ecological metagenomes	metagenomes
mine drainage metagenome	ecological metagenomes	metagenomes
clothing metagenome	ecological metagenomes	metagenomes
root associated fungus metagenome	ecological metagenomes	metagenomes
insect work metagenome	ecological metagenomes	metagenomes
clinical metagenome	ecological metagenomes	metagenomes
bioreactor metagenome	ecological metagenomes	metagenomes
interstitial water metagenome	ecological metagenomes	metagenomes
lagoon metagenome	ecological metagenomes	metagenomes
air conditioner metagenome	ecological metagenomes	metagenomes
book metagenome	ecological metagenomes	metagenomes
alkali spring metagenome	ecological metagenomes	metagenomes
moonmilk metagenome	ecological metagenomes	metagenomes
mud metagenome	ecological metagenomes	metagenomes
oil sands metagenome	ecological metagenomes	metagenomes
iron metagenome	ecological metagenomes	metagenomes
bioanode metagenome	ecological metagenomes	metagenomes
cold spring metagenome	ecological metagenomes	metagenomes
saltern metagenome	ecological metagenomes	metagenomes
stromatolite metagenome	ecological metagenomes	metagenomes
marine metagenome	ecological metagenomes	metagenomes
serofluid metagenome	ecological metagenomes	metagenomes
ant fungus garden metagenome	ecological metagenomes	metagenomes
estuary metagenome	ecological metagenomes	metagenomes
microbial fuel cell metagenome	ecological metagenomes	metagenomes
biofilter metagenome	ecological metagenomes	metagenomes
solid waste metagenome	ecological metagenomes	metagenomes
soda lake metagenome	ecological metagenomes	metagenomes
salt metagenome	ecological metagenomes	metagenomes
mine tailings metagenome	ecological metagenomes	metagenomes
milk metagenome	ecological metagenomes	metagenomes
museum specimen metagenome	ecological metagenomes	metagenomes
neuston metagenome	ecological metagenomes	metagenomes
watershed metagenome	ecological metagenomes	metagenomes
sludge metagenome	ecological metagenomes	metagenomes
food production metagenome	ecological metagenomes	metagenomes
rhizoplane metagenome	ecological metagenomes	metagenomes
gas well metagenome	ecological metagenomes	metagenomes
mucilage metagenome	ecological metagenomes	metagenomes
parchment metagenome	ecological metagenomes	metagenomes
steel metagenome	ecological metagenomes	metagenomes
straw metagenome	ecological metagenomes	metagenomes
monument metagenome	ecological metagenomes	metagenomes
groundwater metagenome	ecological metagenomes	metagenomes
cow dung metagenome	ecological metagenomes	metagenomes
silage metagenome	ecological metagenomes	metagenomes
sulfur spring metagenome	ecological metagenomes	metagenomes
slag metagenome	ecological metagenomes	metagenomes
medical waste metagenome	ecological metagenomes	metagenomes
beach sand metagenome	ecological metagenomes	metagenomes
saline spring metagenome	ecological metagenomes	metagenomes
forest metagenome	ecological metagenomes	metagenomes
termite fungus garden metagenome	ecological metagenomes	metagenomes
aquifer metagenome	ecological metagenomes	metagenomes
anaerobic digester metagenome	ecological metagenomes	metagenomes
cold seep metagenome	ecological metagenomes	metagenomes
activated sludge metagenome	ecological metagenomes	metagenomes
mushroom spawn bag metagenome	ecological metagenomes	metagenomes
dairy metagenome	ecological metagenomes	metagenomes
activated carbon metagenome	ecological metagenomes	metagenomes
rice paddy metagenome	ecological metagenomes	metagenomes
musk metagenome	ecological metagenomes	metagenomes
desalination cell metagenome	ecological metagenomes	metagenomes
surface metagenome	ecological metagenomes	metagenomes
air metagenome	ecological metagenomes	metagenomes
decomposition metagenome	ecological metagenomes	metagenomes
pond metagenome	ecological metagenomes	metagenomes
leachate metagenome	ecological metagenomes	metagenomes
electrolysis cell metagenome	ecological metagenomes	metagenomes
concrete metagenome	ecological metagenomes	metagenomes
soil metagenome	ecological metagenomes	metagenomes
animal product metagenome	ecological metagenomes	metagenomes
snowblower vent metagenome	ecological metagenomes	metagenomes
snow metagenome	ecological metagenomes	metagenomes
medicine metagenome	ecological metagenomes	metagenomes
bog metagenome	ecological metagenomes	metagenomes
microbialite metagenome	ecological metagenomes	metagenomes
leaf litter metagenome	ecological metagenomes	metagenomes
marine plankton metagenome	ecological metagenomes	metagenomes
fishing equipment metagenome	ecological metagenomes	metagenomes
metal metagenome	ecological metagenomes	metagenomes
salt pan metagenome	ecological metagenomes	metagenomes
glacier forefield metagenome	ecological metagenomes	metagenomes
floral nectar metagenome	ecological metagenomes	metagenomes
pitcher plant inquiline metagenome	ecological metagenomes	metagenomes
Winogradsky column metagenome	ecological metagenomes	metagenomes
permafrost metagenome	ecological metagenomes	metagenomes
cave metagenome	ecological metagenomes	metagenomes
wine metagenome	ecological metagenomes	metagenomes
rhizosphere metagenome	ecological metagenomes	metagenomes
salt lake metagenome	ecological metagenomes	metagenomes
industrial waste metagenome	ecological metagenomes	metagenomes
cenote metagenome	ecological metagenomes	metagenomes
tannin metagenome	ecological metagenomes	metagenomes
ivory metagenome	ecological metagenomes	metagenomes
probiotic metagenome	ecological metagenomes	metagenomes
painting metagenome	ecological metagenomes	metagenomes
sediment metagenome	ecological metagenomes	metagenomes
spider web metagenome	ecological metagenomes	metagenomes
ore metagenome	ecological metagenomes	metagenomes
biogas fermenter metagenome	ecological metagenomes	metagenomes
whale fall metagenome	ecological metagenomes	metagenomes
membrane metagenome	ecological metagenomes	metagenomes
soda lime metagenome	ecological metagenomes	metagenomes
phytotelma metagenome	ecological metagenomes	metagenomes
glacier metagenome	ecological metagenomes	metagenomes
honey metagenome	ecological metagenomes	metagenomes
chemical production metagenome	ecological metagenomes	metagenomes
aqua crust metagenome	ecological metagenomes	metagenomes
biofilm metagenome	ecological metagenomes	metagenomes
halite metagenome	ecological metagenomes	metagenomes
winery metagenome	ecological metagenomes	metagenomes
clay metagenome	ecological metagenomes	metagenomes
lichen crust metagenome	ecological metagenomes	metagenomes
runoff metagenome	ecological metagenomes	metagenomes
hydrocarbon metagenome	ecological metagenomes	metagenomes
shale fluid metagenome	ecological metagenomes	metagenomes
oil field metagenome	ecological metagenomes	metagenomes
bioleaching metagenome	ecological metagenomes	metagenomes
factory metagenome	ecological metagenomes	metagenomes
herbal medicine metagenome	ecological metagenomes	metagenomes
tar pit metagenome	ecological metagenomes	metagenomes
wetland metagenome	ecological metagenomes	metagenomes
aquaculture metagenome	ecological metagenomes	metagenomes
aquarium metagenome	ecological metagenomes	metagenomes
bentonite metagenome	ecological metagenomes	metagenomes
anchialine metagenome	ecological metagenomes	metagenomes
egg metagenome	ecological metagenomes	metagenomes
mangrove metagenome	ecological metagenomes	metagenomes
power plant metagenome	ecological metagenomes	metagenomes
dietary supplements metagenome	ecological metagenomes	metagenomes
outdoor metagenome	ecological metagenomes	metagenomes
meat metagenome	ecological metagenomes	metagenomes
mixed culture metagenome	ecological metagenomes	metagenomes
tomb metagenome	ecological metagenomes	metagenomes
biofouling metagenome	ecological metagenomes	metagenomes
salt mine metagenome	ecological metagenomes	metagenomes
manure metagenome	ecological metagenomes	metagenomes
periphyton metagenome	ecological metagenomes	metagenomes
poultry litter metagenome	ecological metagenomes	metagenomes
sand metagenome	ecological metagenomes	metagenomes
adhesive metagenome	ecological metagenomes	metagenomes
peat metagenome	ecological metagenomes	metagenomes
seawater metagenome	ecological metagenomes	metagenomes
coral reef metagenome	ecological metagenomes	metagenomes
biochar metagenome	ecological metagenomes	metagenomes
shale gas metagenome	ecological metagenomes	metagenomes
lake water metagenome	ecological metagenomes	metagenomes
biocathode metagenome	ecological metagenomes	metagenomes
dust metagenome	ecological metagenomes	metagenomes
hydrothermal vent metagenome	ecological metagenomes	metagenomes
alkali sediment metagenome	ecological metagenomes	metagenomes
hospital metagenome	ecological metagenomes	metagenomes
riverine metagenome	ecological metagenomes	metagenomes
wood decay metagenome	ecological metagenomes	metagenomes
brine metagenome	ecological metagenomes	metagenomes
drinking water metagenome	ecological metagenomes	metagenomes
ice metagenome	ecological metagenomes	metagenomes
freshwater sediment metagenome	ecological metagenomes	metagenomes
hot springs metagenome	ecological metagenomes	metagenomes
tidal flat metagenome	ecological metagenomes	metagenomes
shell metagenome	ecological metagenomes	metagenomes
glacier lake metagenome	ecological metagenomes	metagenomes
osmosis membrane metagenome	ecological metagenomes	metagenomes
aquatic metagenome	ecological metagenomes	metagenomes
food fermentation metagenome	ecological metagenomes	metagenomes
flotsam metagenome	ecological metagenomes	metagenomes
landfill metagenome	ecological metagenomes	metagenomes
tin mine metagenome	ecological metagenomes	metagenomes
money metagenome	ecological metagenomes	metagenomes
fairy ring metagenome	ecological metagenomes	metagenomes
freshwater metagenome	ecological metagenomes	metagenomes
hypolithon metagenome	ecological metagenomes	metagenomes
nutrient bag metagenome	ecological metagenomes	metagenomes
mine metagenome	ecological metagenomes	metagenomes
bioreactor sludge metagenome	ecological metagenomes	metagenomes
retting metagenome	ecological metagenomes	metagenomes
marsh metagenome	ecological metagenomes	metagenomes
cloud metagenome	ecological metagenomes	metagenomes
grassland metagenome	ecological metagenomes	metagenomes
terrestrial metagenome	ecological metagenomes	metagenomes
plastic metagenome	ecological metagenomes	metagenomes
marine sediment metagenome	ecological metagenomes	metagenomes
karst metagenome	ecological metagenomes	metagenomes
gas scrubber metagenome	ecological metagenomes	metagenomes
pipeline metagenome	ecological metagenomes	metagenomes
ballast water metagenome	ecological metagenomes	metagenomes
indoor metagenome	ecological metagenomes	metagenomes
wood metagenome	ecological metagenomes	metagenomes
biocrust metagenome	ecological metagenomes	metagenomes
plastisphere metagenome	ecological metagenomes	metagenomes
oasis metagenome	ecological metagenomes	metagenomes
microbial mat metagenome	ecological metagenomes	metagenomes
rock metagenome	ecological metagenomes	metagenomes
fertilizer metagenome	ecological metagenomes	metagenomes
healthcare waste metagneome	ecological metagenomes	metagenomes
abattoir metagenome	ecological metagenomes	metagenomes
biosolids metagenome	ecological metagenomes	metagenomes
microwave metagenome	ecological metagenomes	metagenomes
wastewater metagenome	ecological metagenomes	metagenomes
meiofauna metagenome	ecological metagenomes	metagenomes
medical device metagenome	ecological metagenomes	metagenomes
